p Selects all <p> elements
element.class p.intro	Selects all <p> elements with class="intro"
div, p Selects all <div> elements and all <p> elements
div p	Selects all <p> elements inside <div> elements
div > p	Selects all <p> elements where the parent is a <div> element
div + p	Selects the first <p> element that is placed immediately after <div> elements
p ~ ul	Selects every <ul> element that is preceded by a <p> element
[attribute]	[target]Selects all elements with a target 
[attribute=value][target=_blank]	Selects all elements with target="_blank"
[attribute~=value][title~=flower]	Selects all elements with a title attribute containing the word "flower"
**************************************
[attribute^=value]	a[href^="https"]	Selects every <a> element whose href attribute value begins with "https"

[attribute$=value]a[href$=".pdf"]Selects every <a> element whose href attribute value ends with ".pdf"

::after	p::after	Insert something after the content of each <p> element
::before	p::before	Insert something before the content of each <p> element
:checked	input:checked	Selects every checked <input> element
:default	input:default Selects the default <input> element
:disabled	input:disabled Selects every disabled <input> element
p:empty	Selects every <p> element that has no children (including text nodes)
input:enabled Selects every enabled <input> element
p:first-child Selects every <p> element that is the first child of its parent